NO ./textures/CHOKBAR_1_.xpm
SO ./textures/aladin_1_.xpm
WE ./textures/chokabavar.xpm
EA ./textures/tah_sah.xpm

F   50, 0,127
C   200,150,200

1111111111111111111111111111111
1000000000000000000000000000011
10000000001000000000000000000001
10000000000001000000000000000001
100000000000000011100000000000111
1000000001110000101000000000001 
100000000000100001110000000000011
1000000000W000000000000000000001
100000001100100000000000000000001
10000000011100000000000000000001
10000000000000000000000000000001
10000000000000000000000000000001
10000000000000000000000000000001
10000000000000000000000000000001
10000000000000000000000000000001
10000000000000000000000000000001
10000000000000000000000000000001
10000000000000000000000000000001
10000111111111111111111100000001
10000100000000000000000000000001 1
1000010000000000000000000000000110111
10000010000000000000000000000000101
1111111111111111111111111111111111111