NO ./path_to_the_north_texture
SO ./path_to_the_south_texture
WE ./path_to_the_west_texture
EA ./path_to_the_east_texture
      
			   
F 220,100,
C 225, 30,0,
111111111
1111111111111111
1000000011000001
10000001  1110001
11111001  100001
111111111111111111111111111111
11111000000000S1
100000000000001
1111111111111111