NO ./textures/eagle.xpm
SO ./textures/redbrick.xpm
EA ./textures/greystone.xpm
WE ./textures/purplestone.xpm

F   128,0,05
C   192,82,8


1111111111111111111111111111111
1000000000000000000000000000001
10000000001000000000000000000001
10000000000001000000000000000001
10000000000000001000000000000001
100000000S0000000010000000000001
10000000000000000000100000000001
10000000000000001000000000000001
10000000000010000000000000000001
1000000010000000100000000000001
1000000000000000000000000000001
1000000010000000000000000000001
1000000000000000100000000000001
1000000000000000100000000000001
10000000010000000000000000000001
1000000000000000000000000000001
1000000000000000000000000000001
1000000000000000000000000000001
10000000000010000000000000000001
1000000000000000000000000000001
10000000000001000000000000000001
10000000000100000000000000000001
10000000000000001000000000000001
10000000001000000000000000000001
10000000000000000010000000000001
11111111111111111111111111111111