NO ./textures/eagle.xpm
SO ./textures/redbrick.xpm
WE ./textures/purplestone.xpm
EA ./textures/greystone.xpm

F   128,0,05
C   192,82,8

1111111111111111111111111111111
11S0000000000000000000000000011
10000000001000000000000000000001
10000000000001000000000000000001
10000000000000001000000000000001
10000000000000000000000000000001
10000000000000000000000000000001
10000000000000000000000000000001
10000000000000000000000000000001
10000000000000000000000000000001
10000000000000000000000000000001
10000000000000000000000000000001
10000000000000000000000000000001
10000000000000000000000000000001
10000000000000000000000000000001
10000000000000000000000000000001
10000000000000000000000000000001
10000000000000000000000000000001
10000111111111111111111100000001
10000000000000000000000000000001
10000000000000000000000000000001
10000000000000000000000000000001
11111111111111111111111111111111

1
  


