NO ./textures/palestinou.xpm
SO ./textures/palestinou.xpm
WE ./textures/eny.xpm
EA ./textures/eny.xpm

F   0,255,250
C   200, 150 , 200

1111111111111111111111111111111
1100000000000000000000000000011
10000000001000000000000000000001
10000000000001000000000000000001
10000000000000001110000000000001
10000000000000001010000000000001
10000000000000001110000000000001
1000000000W000000000000000000001
10000000000000000000000000000001
10000000000000000000000000000001
10000000000000000000000000000001
10000000000000000000000000000001
10000000000000000000000000000001
10000000000000000000000000000001
10000000000000000000000000000001
10000000000000000000000000000001
10000000000000000000000000000001
10000000000000000000000000000001
10000111111111111111111100000001
10000000000000000000000000000001
10000000000000000000000000000001
10000000000000000000000000000001
11111111111111111111111111111111

1
  


