NO ./path_to_the_north_texture
SO ./path_to_the_south_texture
WE ./path_to_the_west_texture
EA ./path_to_the_east_texture
  
   
F 220,100,
C 225, 30,0,


111111111
1111111111111111
1000000011000001
10010001  1110001
10000000110000001
100000000000000001
10000000110000011
11000001  100001
100S000011000001
1001000000000001
10000010000000001
1000000000000001
111111111111111111111111111111
1111100000000001
100000000000001
1111111111111111